*********0*
*.........*
*.*********
*........**
********.**
**...*...**
**.*...****
**.********
1..********