*********0**********
*.........***...****
*.*********...*....*
*...........******.*
****************...*
**...*...*******.***
**.*...*.....***.***
**.*********.**..***
**.......***.**.****
********.***..*...**
******...****.***.**
****...******.....**
1....***************