*********0
*********. 
******s..w
**s.w*.***
**.*n.w***
**.*******
**e...s***
******.***
****s.w***
1...w*****
