*********0
*******g*. 
******....
**...*.***
**.*...***
**.*******
**.......*
****g***.*
****.....*
1....***g*
