*********0
*******g*. 
******....
**...*.***
*g.*...***
**.***g***
**.......*
*****g**.*
***g.....*
1....****g
