*********0
*******g*. 
******s..w
**s.w*.g**
*g.*n.w***
**.**g****
*ge.....s*
****g***.*
****s...w*
1...wg****
