*********s
*********. 
******l..r
**l.l*.***
**.*r.r***
**.*******
**l...r***
******.***
****l.r***
e...r*****
