*********0**********
*********.**********
*********........***
**...*...*g*****.***
**.*...*.....***.***
**.*********.**..***
**.......***.**.****
********.***..*...**
******...****.***.**
****...******.....**
1....***************
