*********0
*******g*. 
******....
**...*.***
*g.*...***
**.*******
**.......*
********.*
g***.....*
1....****g
